11111111111111111111
111111111111E1111111
11111111111000110001
11111111111000000C01
11111111111000110001
11111111111111111011
11111111111111111011
11111100000000110001
1111110C000000000C01
11111100000000110001
11111111111111111011
11111111111111111011
11111111111000110001
111111111110C0000C01
11111111111000110001
11111111111101111111
11111111111101111111
10001100011000111111
10C0000C0000C0111111
10001100011000111111
1101111P111111111111
11011111111111111111
10001111111111111111
10001111111111111111
10C01111111111111111
10001111111111111111
11111111111111111111