1111111111111111111111111111111
100000000000000C0000000010000C1
1011101110111010101011101010111
1P10101000001010101000100010001
1110101010101110101110111110101
1000101010101000101000100010101
1110111010101011111111101111111
100010001010101C10001000101C001
1011101111101010101010101011101
101C000010101010001E10100000001
1011111010111110111110101111111
1000100000000010000010100010001
1110111010111010101110111011101
1000000010101010101000001010001
1111101111101010101011111110111
1C00100010101000100010001000001
1110101110101110101110111011111
1C1000100000101C100000100010001
1010111110101011101010101110101
10000000101000000010100000001C1
1111111111111111111111111111111