11111111111111111111111111111
1P000000000000000000000000001
1000000000CCC000000CCCCCCCC01
1000000000CCC000000CCCCCCCC01
10000000CCC000000CCC0000CCC01
10000000CCC000000CCC0000CCC01
100000CCC0CCC000000000CCC0001
100000CCC0CCC000000000CCC0001
1000CCC00CCC0000000CCC0000001
1000CCC00CCC0000000CCC0000001
10CCCCCCCCCCC000CCC0000000001
10CCCCCCCCCCC000CCC0000000001
1000000CCC0000CCC000000000001
1000000CCC0000CCC000000000001
10000CCC000CCCCCCCCCCC0000001
10000CCC000CCCCCCCCCCC0000001
100000000000000000000000000E1
11111111111111111111111111111