11111111111111111111111111111111111111111111111111
1P100000001000C00001C000000000011C000000C0000010E1
10101111101011111101111011111101111000011100001001
1000000C10000000C1000000100000000000111111111000C1
11111111111111111111111111111111111111111111111111