1111111111
10C010C1C1
1010101101
1E100C0P01
1111111111